1111111111011
100100000C001
1000011111001
1P0011E000001
1111111111111