111111111111
101000P001C1
11000000C001
10011E000C01
101111100111
111111111111