111111111111
1010000001C1
1100P0Z0C001
10011E000C01
101111100111
111111111111